DAHPSYN-RXN	phosphoenolpyruvate + D-erythrose 4-phosphate + H2O = 3-deoxy-D-arabino-heptulosonate-7-phosphate + orthophosphate	chorismate biosynthesis I
3-DEHYDROQUINATE-SYNTHASE-RXN	3-deoxy-D-arabino-heptulosonate-7-phosphate = 3-dehydroquinate + orthophosphate	chorismate biosynthesis I
3-DEHYDROQUINATE-DEHYDRATASE-RXN	3-dehydroquinate = 3-dehydroshikimate + H2O	chorismate biosynthesis I
SHIKIMATE-5-DEHYDROGENASE-RXN	shikimate + NADP+ = 3-dehydroshikimate + NADPH + H+	chorismate biosynthesis I
SHIKIMATE-KINASE-RXN	shikimate + ATP = shikimate-3-phosphate + ADP + H+	chorismate biosynthesis I
2.5.1.19-RXN	shikimate-3-phosphate + phosphoenolpyruvate = 5-O-(1-Carboxylatovinyl)-3-phosphonatoshikimate + orthophosphate	chorismate biosynthesis I
CHORISMATE-SYNTHASE-RXN	5-O-(1-Carboxylatovinyl)-3-phosphonatoshikimate = chorismate + orthophosphate	chorismate biosynthesis I
CHORISMATEMUT-RXN	chorismate = prephenate	L-tyrosine biosynthesis I
PREPHENATEDEHYDROG-RXN	prephenate + NAD+ = 3-(4-hydroxyphenyl)pyruvate + CO2 + NADH	L-tyrosine biosynthesis I
TYROSINE-AMINOTRANSFERASE-RXN	 3-(4-hydroxyphenyl)pyruvate + L-glutamate = L-tyrosine + 2-oxoglutarate	L-tyrosine biosynthesis I
ANTHRANSYN-RXN	chorismate + L-glutamine = anthranilate + L-glutamate + pyruvate + H+	L-tryptophan biosynthesis
PRTRANS-RXN	anthranilate + 5-phospho-alpha-D-ribose-1-diphosphate = N-(5-phosphoribosyl)-anthranilate + diphosphate 	L-tryptophan biosynthesis
PRAISOM-RXN	N-(5-phosphoribosyl)-anthranilate = 1-(2-carboxyphenylamino)-1-deoxy-D-ribulose 5-phosphate	L-tryptophan biosynthesis
IGPSYN-RXN	1-(2-carboxyphenylamino)-1-deoxy-D-ribulose 5-phosphate + H+ = (1S,2R)-1-C-(indol-3-yl)glycerol-3-phosphate + CO2 + H2O	L-tryptophan biosynthesis
RXN0-2381	(1S,2R)-1-C-(indol-3-yl)glycerol-3-phosphate = indole + D-glyceraldehyde 3-phosphate	L-tryptophan biosynthesis
RXN0-2382	L-serine + indole = L-tryptophan + H2O	L-tryptophan biosynthesis
PRPPSYN-RXN	D-ribose 5-phosphate + ATP = 5-phospho-alpha-D-ribose-1-diphosphate + AMP + H+	PRPP biosynthesis
ATPPHOSPHORIBOSYLTRANS-RXN	ATP + 5-phospho-alpha-D-ribose-1-diphosphate = 1-(5-phospho-beta-D-ribosyl)-ATP + diphosphate 	L-histidine biosynthesis
HISTPRATPHYD-RXN	1-(5-phospho-beta-D-ribosyl)-ATP + H2O = 1-(5-phospho-beta-D-ribosyl)-AMP + diphosphate + H+	L-histidine biosynthesis
HISTCYCLOHYD-RXN	1-(5-phospho-beta-D-ribosyl)-AMP + H2O = 1-(5-phospho-beta-D-ribosyl)-5-[(5-phosphoribosylamino)methylideneamino]imidazole-4-carboxamide	L-histidine biosynthesis
PRIBFAICARPISOM-RXN	1-(5-phospho-beta-D-ribosyl)-5-[(5-phosphoribosylamino)methylideneamino]imidazole-4-carboxamide = phosphoribulosylformimino-AICAR-phosphate	L-histidine biosynthesis
GLUTAMIDOTRANS-RXN	phosphoribulosylformimino-AICAR-phosphate + L-glutamine = L-glutamate + D-erythro-1-(imidazol-4-yl)-glycerol-3-phosphate + 5-amino-1-(5-phospho-D-ribosyl)imidazole-4-carboxamide + H+	L-histidine biosynthesis
IMIDPHOSDEHYD-RXN	D-erythro-1-(imidazol-4-yl)-glycerol-3-phosphate = 3-(imidazol-4-yl)-2-oxopropyl-phosphate + H2O	L-histidine biosynthesis
HISTAMINOTRANS-RXN	  3-(imidazol-4-yl)-2-oxopropyl-phosphate + L-glutamate = L-histidinol-phosphate + 2-oxoglutarate	L-histidine biosynthesis
HISTIDPHOS-RXN	L-histidinol-phosphate + H2O =  histidinol + orthophosphate	L-histidine biosynthesis
HISTOLDEHYD-RXN	histidinol + NAD+ = histidinal + NADH + H+	L-histidine biosynthesis
HISTALDEHYD-RXN	histidinal + NAD+ + H2O = L-histidine + NADH + 2 H+	L-histidine biosynthesis
ASPARTATEKIN-RXN	L-aspartate + ATP = L-aspartyl-4-phosphate + ADP	L-lysine biosynthesis I
ASPARTATE-SEMIALDEHYDE-DEHYDROGENASE-RXN	L-aspartate-4-semialdehyde + NADP+ + orthophosphate = L-aspartyl-4-phosphate + NADPH + H+	L-lysine biosynthesis I
DIHYDRODIPICSYN-RXN	pyruvate + L-aspartate-4-semialdehyde = (2S,4S)-4-hydroxy-2,3,4,5-tetrahydrodipicolinate + H2O + H+	L-lysine biosynthesis I
RXN-14014	(S)-2,3,4,5-tetrahydrodipicolinate + NADP+ + H2O = (2S,4S)-4-hydroxy-2,3,4,5-tetrahydrodipicolinate + NADPH + H+	L-lysine biosynthesis I
TETHYDPICSUCC-RXN	(S)-2,3,4,5-tetrahydrodipicolinate + succinyl-CoA + H2O = N-succinyl-2-amino-6-ketopimelate + coenzyme A	L-lysine biosynthesis I
SUCCINYLDIAMINOPIMTRANS-RXN	2-oxoglutarate + N-succinyl-L,L-2,6-diaminopimelate = L-glutamate + N-succinyl-2-amino-6-ketopimelate	L-lysine biosynthesis I
SUCCDIAMINOPIMDESUCC-RXN	N-succinyl-L,L-2,6-diaminopimelate + H2O = L,L-diaminopimelate + succinate	L-lysine biosynthesis I
DIAMINOPIMEPIM-RXN	L,L-diaminopimelate = meso-diaminopimelate	L-lysine biosynthesis I
DIAMINOPIMDECARB-RXN	meso-diaminopimelate + H+ = L-lysine + CO2	L-lysine biosynthesis I
HOMOSERKIN-RXN	L-homoserine + ATP = O-phospho-L-homoserine + ADP + H+	L-threonine biosynthesis
THRESYN-RXN	O-phospho-L-homoserine + H2O = L-threonine + orthophosphate	L-threonine biosynthesis
THREONINE-ALDOLASE-RXN	L-threonine = glycine + acetaldehyde	glycine biosynthesis IV
GLYOHMETRANS-RXN	L-serine + tetrahydrofolate = glycine + 5,10-methylenetetrahydrofolate + H2O	glycine biosynthesis I
