RIBULOSE-BISPHOSPHATE-CARBOXYLASE-RXN	D-ribulose-1,5-bisphosphate + CO2 + H2O = 2 3-phospho-D-glycerate + 2 H+ 	Calvin-Benson-Bassham cycle
PHOSGLYPHOS-RXN	3-phospho-D-glycerate + ATP = 3-phospho-D-glyceroyl-phosphate + ADP	Calvin-Benson-Bassham cycle; glycolysis
GAPOXNPHOSPHN-RXN	3-phospho-D-glyceroyl-phosphate + NADH + H+ = D-glyceraldehyde 3-phosphate + NAD+ + phosphate	gluconeogenesis I; glycolysis I
1.2.1.13-RXN	D-glyceraldehyde 3-phosphate + NADP+ + phosphate  =  3-phospho-D-glyceroyl-phosphate + NADPH + H+	Calvin-Benson-Bassham cycle
TRIOSEPISOMERIZATION-RXN	D-glyceraldehyde 3-phosphate = glycerone phosphate	Calvin-Benson-Bassham cycle; glycolysis
F16ALDOLASE-RXN	glycerone phosphate + D-glyceraldehyde 3-phosphate = beta-D-fructose 1,6-bisphosphate	Calvin-Benson-Bassham cycle; glycolysis I; gluconeogenesis
F16BDEPHOS-RXN	beta-D-fructose 1,6-bisphosphate + H2O = beta-D-fructofuranose 6-phosphate + phosphate	Calvin-Benson-Bassham cycle; glycolysis I; gluconeogenesis
2TRANSKETO-RXN	beta-D-fructofuranose 6-phosphate + D-glyceraldehyde 3-phosphate = D-erythrose 4-phosphate + D-xylulose 5-phosphate	Calvin-Benson-Bassham cycle; Rubisco shunt
RIBULP3EPIM-RXN	D-xylulose 5-phosphate = D-ribulose 5-phosphate	Calvin-Benson-Bassham cycle
1TRANSKETO-RXN	D-sedoheptulose 7-phosphate + D-glyceraldehyde 3-phosphate = D-ribose 5-phosphate + D-xylulose 5-phosphate	Calvin-Benson-Bassham cycle
SEDOHEPTULOSE-BISPHOSPHATASE-RXN	D-sedoheptulose-1,7-bisphosphate + H2O = D-sedoheptulose 7-phosphate + phosphate	Calvin-Benson-Bassham cycle
RIB5PISOM-RXN	D-ribose 5-phosphate = D-ribulose 5-phosphate	Calvin-Benson-Bassham cycle
PHOSPHORIBULOKINASE-RXN	D-ribulose 5-phosphate + ATP = D-ribulose-1,5-bisphosphate + ADP + H+	Calvin-Benson-Bassham cycle
SEDOBISALDOL-RXN	glycerone phosphate + D-erythrose 4-phosphate = D-sedoheptulose-1,7-bisphosphate	Calvin-Benson-Bassham cycle
TRANSALDOL-RXN	D-sedoheptulose 7-phosphate + D-glyceraldehyde 3-phosphate = beta-D-fructofuranose 6-phosphate + D-erythrose 4-phosphate	non-oxiidative PPP
6PFRUCTPHOS-RXN	ATP + beta-D-fructofuranose 6-phosphate = ADP + beta-D-fructose 1,6-bisphosphate + H+	glycolysis I
RXN-15513	2-phospho-D-glycerate = 3-phospho-D-glycerate	glycolysis I
PGLUCISOM-RXN	D-glucopyranose 6-phosphate = beta-D-fructofuranose 6-phosphate	glycolysis I
2PGADEHYDRAT-RXN	2-phospho-D-glycerate = phosphoenolpyruvate + H2O	glycolysis I; gluconeogenesis I
PEPDEPHOS-RXN	phosphoenolpyruvate + ADP + H+ = pyruvate + ATP	glycolysis I
PDH	COA + NAD+ + PYRUVATE = ACETYL-COA + CO2 + NADH	Pyruvate Dehydrogenase Rxn
CITSYN-RXN	acetyl-CoA + oxaloacetate + H2O = citrate + coenzyme A + H+	TCA cycle I
ACONITATEDEHYDR-RXN	citrate = cis-aconitate + H2O	TCA cycle I
ACONITATEHYDR-RXN	cis-aconitate + H2O = D-threo-isocitrate	TCA cycle I
ISOCITDEH-RXN	D-threo-isocitrate + NAD+ = 2-oxoglutarate + CO2 + NADH	TCA cycle I
2OXOGLUTARATEDEH-RXN	2-oxoglutarate + coenzyme A + NAD+ = succinyl-CoA + CO2 + NADH	TCA cycle I
SUCCCOASYN-RXN	succinyl-CoA + ADP + phosphate = succinate + ATP + coenzyme A	TCA cycle I
RXN-14971	succinate + NAD+ = fumarate + NADH	TCA cycle I
FUMHYDR-RXN	fumarate + H2O = (S)-malate	TCA cycle I
MALATE-DEH-RXN	(S)-malate + NAD+ = oxaloacetate + NADH + H+	TCA cycle I
ISOCIT-CLEAV-RXN	D-threo-isocitrate = glyoxylate + succinate	glyoxylate shunt
MALSYN-RXN	acetyl-CoA + glyoxylate + H2O = (S)-malate + coenzyme A + H+	Glyoxylate shunt
ALCOHOL-DEHYDROG-RXN	ethanol + NAD+  =  acetaldehyde + NADH + H+	ethanol degradation II
RXN66-3	acetaldehyde + NAD+ + H2O  =  acetate + NADH + 2 H+	ethanol degradation II
ACETATE--COA-LIGASE-RXN	acetate + ATP + coenzyme A  =  acetyl-CoA + AMP + diphosphate	ethanol degradation II
# Glutamate biosynthesis
#GLUTAMATESYN-RXN	L-glutamine + 2-oxoglutarate + NADPH + H+ =  2 L-glutamate + NADP+	L-glutamate biosynthesis I
# Methionine biosynthesis from aspartate
ASPAMINOTRANS-RXN	oxaloacetate + L-glutamate = L-aspartate + 2-oxoglutarate 	L-aspartate biosynthesis
ASPARTATEKIN-RXN	L-aspartate + ATP  =  L-aspartyl-4-phosphate + ADP	L-homoserine biosynthesis
ASPARTATE-SEMIALDEHYDE-DEHYDROGENASE-RXN	L-aspartyl-4-phosphate + NADPH = L-aspartate-semialdehyde + NADP+ + phosphate	L-homoserine biosynthesis
HOMOSERDEHYDROG-RXN	L-aspartate-semialdehyde + NADPH = L-homoserine + NADP+ 	L-homoserine biosynthesis
HOMOSERINE-O-ACETYLTRANSFERASE-RXN	L-homoserine + acetyl-CoA  =  O-acetyl-L-homoserine + coenzyme A	L-methionine biosynthesis III
ACETYLHOMOSER-CYS-RXN	O-acetyl-L-homoserine + H2S =  L-homocysteine + acetate	 L-methionine biosynthesis III
HOMOCYSMET-RXN	L-homocysteine + 5-methyltetrahydrofolate  =  L-methionine + tetrahydrofolate	S-adenosyl-L-methionine cycle II,S-adenosyl-L-methionine cycle I
#HOMOCYSMETB12-RXN	L-homocysteine + 5-methyltetrahydrofolate  =  L-methionine + tetrahydrofolate	L-methionine biosynthesis III
# SAM Cycles:
S-ADENMETSYN-RXN	ATP + L-methionine + H2O  =  S-adenosyl-L-methionine + phosphate + diphosphate	S-adenosyl-L-methionine cycle II, S-adenosyl-L-methionine cycle I
RXN-7605	S-adenosyl-L-methionine + tetrahydrofolate  =  S-adenosyl-L-homocysteine + 5-methyltetrahydrofolate	S-adenosyl-L-methionine cycle II, S-adenosyl-L-methionine cycle I
ADENOSYLHOMOCYSTEINASE-RXN	S-adenosyl-L-homocysteine + H2O  =  L-homocysteine + adenosine	S-adenosyl-L-methionine cycle II
ADENOSYLHOMOCYSTEINE-NUCLEOSIDASE-RXN	S-adenosyl-L-homocysteine + H2O  =  S-ribosyl-L-homocysteine + adenine	S-adenosyl-L-methionine cycle I
RIBOSYLHOMOCYSTEINASE-RXN	S-ribosyl-L-homocysteine  =  L-homocysteine + (4S)-4,5-Dihydroxypentan-2,3-dione	S-adenosyl-L-methionine cycle I
# MISC-RXN	Adenine + Ribose = Adenosine + H2O 	Misc reaction
# GS-GOGAT reactions:
GLUTAMINESYN-RXN	NH3 + L-glutamate + ATP = L-glutamine + ADP + phosphate + H+	GLNSYN-PWY
GLUTAMATESYN-RXN	L-glutamine + 2-oxoglutarate + NADPH + H+ = 2 L-glutamate + NADP+	GLUTSYN-PWY
#SAM1	S-adenosyl-L-methionine + H2O = adenine + (4S)-4,5-DIHYDROXYPENTAN-2,3-DIONE + L-methionine	SAM1
#SAM2	S-adenosyl-L-methionine + H2O = adeninosine + L-methionine	SAM2
#MISC_SAM	S-adenosyl-L-methionine + phosphate + diphosphate = L-Methionine + ATP + H2O	MISC
# Serine and L-Cys biosynthesis
PGLYCDEHYDROG-RXN	3-phospho-D-glycerate + NAD+ = 3-phosphooxypyruvate + NADH 	L-serine biosynthesis
PSERTRANSAM-RXN	3-phospho-L-serine + 2-oxoglutarate = L-glutamate + 3-phosphooxypyruvate	L-serine biosynthesis
RXN0-5114	3-phospho-L-serine + H2O = L-serine + phosphate	L-serine biosynthesis
CYSTATHIONINE-BETA-SYNTHASE-RXN	L-serine + L-homocysteine = L-cystathionine + H2O	L-cysteine biosynthesis VI (from L-methionine)
O-SUCCHOMOSERLYASE-RXN	O-succinyl-L-homoserine + L-cysteine = L-cystathionine + succinate + H+	L-cysteine biosynthesis VI (from L-methionine)
HOMSUCTRAN-RXN	L-homoserine + succinyl-CoA  =  O-succinyl-L-homoserine + COA	
SERINE-O-ACETTRAN-RXN	L-serine + acetyl-CoA = O-acetyl-L-serine + COA	L-cysteine biosynthesis I
ACSERLY-RXN	O-acetyl-L-serine + H2S = L-cysteine + acetate 	L-cysteine biosynthesis I
